blokken	blocks
isblok	isblock
blokken	blocks
vierkanten	squares
cirkelpatroon	circlepattern
breedte	width
hoogte	height
huidige	current
alle	every
blokposities	blockpositions
staat	is
het	the
blok	block
op	on
aan	on
houdt	keeps
bij	track
welke	which
dit	this

rechts	right
bal	ball
links	left
speler	player
pauze	pause
raakt	hits
tot	til
besturing	controls
spelers	players

de	the
stuiter	bounce
onder	below
variabelen	variables
verplaatsing	movement
STUITER	BOUNCE
hele	whole
veld	field
plus	add
